18 18 18 18 18 18 18 18 18 18 18 18 18 18 18 18 18 18 18 18 18 18 18 18 18 18 18 18 18 18 18 18 18 18 18 18 18 18 18 18 18 18 18 18 18 18 18 18 18 18 
18 18 18 18 18 18 18 18 18 19 18 18 18 18 18 18 18 18 18 18 18 18 18 18 18 18 18 18 18 18 18 18 18 18 18 18 18 18 18 18 18 18 18 18 18 18 18 18 18 18 
18 18 18 18 18 18 18 18 18 18 18 18 18 18 18 18 18 18 18 18 18 18 18 18 18 18 18 18 18 18 18 18 18 18 18 18 18 18 18 18 18 18 18 18 18 18 18 18 18 18 
18 18 18 19 18 18 18 18 18 18 18 18 18 18 18 18 18 18 18 18 18 18 18 18 18 18 18 19 18 18 18 18 18 18 18 19 18 18 18 18 18 18 18 18 18 18 18 18 18 18 
18 18 18 18 18 18 19 18 18 18 18 18 18 18 18 18 18 19 18 18 18 18 19 18 18 18 18 18 18 18 18 18 18 18 18 18 18 18 18 18 18 18 18 18 18 18 18 18 18 18 
18 18 18 18 18 18 18 18 18 18 18 18 19 18 18 18 18 18 18 18 18 18 18 18 18 18 18 18 18 19 18 19 18 18 18 18 18 18 18 18 18 18 18 18 18 18 18 18 18 18 
18 18 18 18 18 18 18 18 28 26 26 26 26 26 26 26 29 18 28 26 26 26 26 26 26 26 26 29 18 18 18 28 26 26 26 26 26 26 26 26 26 26 29 18 18 18 18 18 18 18 
18 19 18 18 18 18 18 18 24 1 32 32 32 32 32 1 25 26 27 1 1 1 1 1 1 1 1 25 26 26 26 27 1 1 12 10 10 10 10 10 10 13 23 18 18 19 18 18 18 18 
18 18 18 18 18 18 18 18 24 1 32 17 17 17 32 1 1 1 1 1 1 20 21 21 21 22 1 1 1 1 1 1 1 1 8 3 3 3 3 3 3 7 23 18 18 18 18 18 18 18 
18 18 18 18 18 18 18 18 24 1 32 17 36 17 32 1 1 1 1 1 1 23 18 18 18 24 1 1 1 1 1 1 1 1 8 3 3 3 3 3 3 7 23 18 18 18 18 19 18 18 
18 18 18 18 18 18 18 18 24 1 32 17 17 17 32 1 1 1 1 1 1 23 18 18 18 24 1 1 1 1 1 1 1 1 8 3 3 3 3 3 3 7 23 19 18 18 18 18 18 18 
18 18 19 18 18 18 18 18 24 1 32 17 17 17 32 1 1 1 1 1 1 25 26 26 26 27 1 1 1 1 1 1 1 1 8 3 3 3 3 3 3 7 23 18 18 18 18 18 18 18 
18 18 18 18 18 19 18 18 24 1 32 32 17 32 32 1 1 1 1 1 1 1 12 10 13 1 1 1 1 1 1 1 1 1 14 5 5 6 3 4 5 15 23 18 18 18 18 18 18 18 
18 18 18 18 18 18 18 18 24 1 1 1 1 1 1 1 1 1 1 1 1 1 8 3 7 1 1 1 1 1 1 1 1 1 1 1 1 8 3 7 20 21 31 18 18 18 19 18 18 18 
18 18 18 18 18 18 18 18 30 22 1 1 1 1 1 1 1 1 1 1 1 1 8 3 7 1 1 1 1 1 1 1 1 1 1 1 1 8 3 7 23 18 18 18 18 18 18 18 18 18 
18 19 18 18 18 18 18 19 18 24 1 1 1 1 1 1 1 1 1 1 1 1 8 3 7 1 1 1 1 1 1 1 1 1 1 1 1 8 3 7 23 19 18 18 18 18 18 18 18 18 
18 18 18 18 18 18 18 18 28 27 1 1 1 1 1 1 1 1 1 1 1 1 8 3 7 1 1 1 1 1 1 1 1 1 1 1 1 8 3 7 23 18 18 19 18 18 18 18 18 18 
18 18 18 18 18 18 18 28 27 1 1 1 1 1 1 1 1 1 1 1 1 1 8 3 7 1 1 1 1 1 1 1 1 1 1 12 10 11 3 7 23 18 18 18 18 18 18 18 18 18 
18 18 18 18 18 18 18 24 1 1 1 1 1 1 1 1 1 1 1 1 1 1 8 3 7 1 1 1 1 1 1 1 1 1 1 8 3 3 3 7 23 18 18 18 18 18 19 18 18 18 
18 18 18 18 18 19 18 24 1 1 1 1 1 1 1 1 1 1 1 1 1 1 8 3 7 1 1 1 1 1 1 1 1 1 1 8 3 4 5 15 23 18 18 18 18 18 18 18 18 18 
18 18 18 18 18 18 18 24 1 1 1 1 1 1 12 10 10 10 10 10 10 10 11 3 9 10 10 10 10 13 1 1 1 12 10 11 3 7 1 1 23 18 18 19 18 18 18 18 18 18 
18 18 18 19 18 18 18 24 1 1 1 1 1 1 8 3 3 3 3 3 3 3 3 3 3 3 3 3 3 7 1 1 1 8 3 3 3 7 1 20 31 18 18 18 18 18 18 18 18 18 
18 18 18 18 18 18 18 24 1 1 1 1 1 1 14 5 5 5 5 5 5 5 6 3 4 5 5 5 5 15 1 1 1 14 5 6 3 7 2 23 18 18 19 18 18 18 18 18 18 18 
18 18 18 18 18 18 18 30 22 1 1 1 1 1 1 1 1 1 1 1 1 1 8 3 7 1 1 1 1 1 1 1 1 1 1 8 3 7 1 23 18 18 18 18 18 18 18 18 18 18 
18 18 18 18 18 18 18 18 24 1 1 1 1 1 1 1 1 1 1 1 1 1 8 3 7 1 1 1 1 1 1 1 1 1 1 8 3 7 1 23 18 18 18 18 18 18 18 18 18 18 
18 18 18 18 18 18 18 18 27 1 1 1 1 1 1 1 1 1 1 1 1 1 8 3 7 1 1 1 1 1 1 1 1 1 1 8 3 7 1 23 18 18 18 18 18 18 19 18 18 18 
18 18 18 19 18 18 18 24 1 1 1 1 1 1 1 1 1 1 1 1 1 1 8 3 7 1 1 1 1 1 1 1 1 1 1 8 3 7 1 23 18 18 18 18 18 18 18 18 18 18 
18 18 18 18 18 18 18 24 1 1 1 1 1 1 1 1 1 1 1 1 1 1 8 3 7 1 1 1 1 1 1 1 1 1 1 8 3 7 1 23 18 18 18 18 18 18 18 18 18 18 
18 18 18 18 18 18 18 24 1 1 1 1 1 1 1 1 1 1 1 1 1 1 8 3 7 1 1 1 1 1 1 1 1 1 1 8 3 7 1 23 18 18 19 18 18 18 18 18 18 18 
18 18 19 18 18 18 18 24 1 1 1 1 1 1 1 1 1 1 1 1 1 1 8 3 7 1 1 1 1 1 1 1 1 1 1 14 5 15 1 23 18 18 18 18 18 18 18 18 18 18 
18 18 18 18 18 18 18 24 1 1 1 2 1 1 1 1 1 1 1 1 1 1 8 3 7 1 1 1 1 1 1 1 1 1 1 1 1 1 20 31 18 18 18 18 18 18 18 18 18 18 
18 18 18 18 18 18 19 30 22 1 1 1 1 1 1 1 1 1 1 1 1 1 8 3 7 1 1 1 1 1 1 1 1 1 1 1 1 1 23 18 19 18 18 18 18 18 18 18 18 18 
18 18 18 18 18 18 18 18 24 1 1 1 1 2 1 1 1 1 1 1 1 1 8 3 7 1 1 1 1 1 1 1 1 1 1 1 1 1 23 18 18 18 18 18 18 18 18 19 18 18 
18 18 18 18 18 18 18 18 24 1 1 1 1 1 1 1 1 1 1 1 1 1 8 3 7 1 1 1 1 1 1 1 1 1 1 1 1 2 23 18 18 18 18 18 18 18 18 18 18 18 
18 18 18 18 19 18 18 18 24 1 1 1 1 1 1 1 1 1 1 1 1 1 8 3 7 1 1 1 1 1 1 1 1 1 1 1 1 1 23 18 18 18 18 18 18 18 18 18 18 18 
18 18 18 18 18 18 18 28 27 1 1 1 1 1 1 1 1 1 1 1 1 1 14 5 15 1 1 1 1 1 1 1 1 1 1 1 1 1 25 29 18 18 18 18 18 18 18 18 18 18 
18 18 18 18 18 18 18 24 1 1 1 1 1 1 1 1 1 1 1 1 1 1 1 1 1 1 1 1 1 1 1 1 1 1 1 1 1 1 1 25 29 18 18 19 18 18 18 18 18 18 
18 18 18 18 18 18 18 24 1 1 1 1 1 1 1 1 1 1 1 1 1 1 1 2 1 1 1 1 1 1 1 1 1 1 1 2 1 1 1 1 23 18 18 18 18 18 18 18 18 18 
18 18 18 18 18 18 18 24 1 1 1 1 1 1 1 1 1 1 1 1 1 1 1 1 1 1 1 1 1 1 1 1 1 1 1 1 1 1 1 1 23 18 18 18 18 18 18 18 18 18 
18 18 18 18 18 18 18 24 1 1 33 1 1 1 1 1 1 1 1 1 1 1 1 1 1 1 2 1 1 1 1 1 1 1 1 1 1 1 1 2 23 18 18 18 18 18 18 18 18 18 
18 18 18 18 18 19 18 24 1 1 1 1 1 1 1 1 1 1 1 1 2 1 1 1 1 1 1 1 1 1 1 1 1 1 1 1 1 1 1 1 23 18 18 18 18 18 18 18 18 18 
18 18 18 18 18 18 18 24 1 1 1 1 1 1 1 20 21 21 22 1 1 1 1 1 1 1 1 20 21 21 22 1 1 1 1 1 1 1 1 1 23 18 18 18 18 18 18 18 18 18 
18 19 18 18 18 18 18 24 1 1 1 1 1 1 20 31 18 18 30 22 1 1 1 1 1 1 20 31 18 18 24 1 1 1 1 1 1 1 1 1 23 18 18 18 18 18 19 18 18 18 
18 18 18 18 18 18 18 30 21 21 21 21 21 21 31 18 18 18 18 30 21 21 21 21 21 21 31 18 18 18 30 22 1 1 1 1 1 1 20 21 31 18 19 18 18 18 18 18 18 18 
18 18 18 18 18 18 18 18 18 18 18 18 18 18 19 18 18 18 18 18 18 18 18 18 18 18 18 18 19 18 18 30 21 21 21 21 21 21 31 18 18 18 18 18 18 18 18 18 18 18 
18 18 18 18 19 18 18 18 18 18 18 18 18 18 18 18 18 18 18 18 18 18 18 18 18 18 18 18 18 18 18 18 19 18 18 18 18 18 18 19 18 18 18 18 18 18 18 18 18 18 
18 18 18 18 18 18 18 18 18 19 18 18 18 18 18 18 18 18 18 18 18 18 18 19 18 18 18 18 18 18 18 18 18 18 18 18 18 18 18 18 18 18 18 18 18 19 18 18 18 18 
18 18 18 18 18 18 18 18 18 18 18 18 18 18 18 18 18 18 18 18 18 18 18 18 18 18 18 18 18 18 18 18 18 18 18 18 18 18 18 18 18 18 18 18 18 18 18 18 18 18 
18 18 18 18 18 18 18 18 18 18 18 18 18 18 18 18 18 18 18 18 18 18 18 18 18 18 18 18 18 18 18 18 18 18 18 18 18 18 18 18 18 18 18 18 18 18 18 18 18 18 
18 18 18 18 18 18 18 18 18 18 18 18 18 18 18 18 18 18 18 18 18 18 18 18 18 18 18 18 18 18 18 18 18 18 18 18 18 18 18 18 18 18 18 18 18 18 18 18 18 18 
